# 【翻译说明】
# 中文直接填在等于号后方
# 请保留半角的()及其中的内容

# 当前状态（CurrentState）
# 本段翻译：红圈、四季天书

Roll (deg)=横滚 (deg)
Pitch (deg)=俯仰 (deg)
Yaw (deg)=偏航 (deg)
GroundCourse (deg)=地面航线 (deg)
Latitude (dd)=纬度 (dd)
Longitude (dd)=经度 (dd)
Altitude (dist)=高度 (dist)
Alt Home Offset (dist)=家的高度补偿 (dist)
Gps Status=GPS状态
Gps HDOP=GPS HDOP
Sat Count=卫星数
AirSpeed (speed)=空速 (speed)
Airspeed Target (speed)=空速目标 (speed)
Airspeed Ratio=空速系数
GroundSpeed (speed)=地速 (speed)
Accel X=加速度 X
Accel Y=加速度 Y
Accel Z=加速度 Z
Gyro X=陀螺仪 X
Gyro Y=陀螺仪 Y
Gyro Z=陀螺仪 Z
Mag X=罗盘 X
Mag Y=罗盘 Y
Mag Z=罗盘 Z
Accel2 X=加速度2 X
Accel2 Y=加速度2 Y
Accel2 Z=加速度2 Z
Gyro2 X=陀螺仪2 X
Gyro2 Y=陀螺仪2 Y
Gyro2 Z=陀螺仪2 Z
Mag2 X=罗盘2 X
Mag2 Y=罗盘2 Y
Mag2 Z=罗盘2 Z
Mag Field=磁场
Accel Strength=加速度强度
Gyro Strength=陀螺仪强度
Failsafe=故障保护
RX Rssi=接收信号强度
Vertical Speed (speed)=升降速度 (speed)
Wind Direction (Deg)=风向 (Deg)
Wind Velocity (speed)=风速 (speed)
Roll Target (deg)=横滚目标 (deg)
Pitch Target (deg)=俯仰目标 (deg)
Bearing Target (deg)=方位目标 (deg)
Dist to WP (dist)=航点距离 (dist)
Altitude Error (dist)=高度误差 (dist)
Bearing Error (deg)=方位误差 (deg)
Airspeed Error (speed)=空速误差 (speed)
Xtrack Error (m)=Xtrack错误 (m)
Mode=模式
ClimbRate (speed)=爬升速率 (speed)
Time over Target (sec)=到目标所需时间 (sec)
Time over Home (sec)=到家所需时间 (sec)
Dist Traveled (dist)=行驶距离 (dist)
Time in Air (sec)=留空时间 (sec)
Turn Rate (speed)=转弯速率 (speed)
Turn Radius (dist)=转弯半径 (dist)
Bat Voltage (V)=电池电压 (V)
Bat Remaining (%)=电池剩余 (%)
Bat Current (Amps)=电池电流 (Amps)
Bat Watts=电池瓦数
Bat used EST (mah)=电池用量估算 (mah)
Bat2 Voltage (V)=电池2电压 (V)
Bat2 Current (Amps)=电池2电流 (Amps)
Distance to Home (dist)=家的距离 (dist)
Distance From Moving Base (dist)=流动站的距离 (dist)
Elevation to Mav (deg)=到飞行器的仰角 (deg)
Bearing to Mav (deg)=到飞行器的方位 (deg)
Sonar Range (meters)=声纳距离 (meters)
Sonar Voltage (Volt)=声纳电压 (Volt)
3DR Radio rssi=3DR电台信号强度
3DR Radio remote rssi=3DR电台遥控信号强度
3DR Radio noise=3DR电台噪声
3DR Radio remote noise=3DR电台遥控噪声
3DR Radio snr=3DR电台信噪比
3DR Radio remote snr=3DR电台遥控信噪比
3DR Radio est dist (m)=3DR电台估算距离 (m)
HW Voltage=硬件电压
Board Voltage=主板电压
Servo Rail Voltage=舵机干线电压
Voltage Flags=电压状态
flow_comp_m_x=光流_comp_m_x*
flow_comp_m_y=光流_comp_m_y*
flow_x=光流_x*
flow_y=光流_y*
flow quality=光流质量*