Roll (deg)=Крен (deg)
Pitch (deg)=Тангаж (deg)
Yaw (deg)=Рискання (deg)
GroundCourse (deg)=Шляховий кут (deg)
Latitude (dd)=Широта (dd)
Longitude (dd)=Довгота (dd)
Altitude (dist)=Висота (dist)
Alt Home Offset (dist)=Компенсація висоти дом.точки (dist)
Gps Status=Стан GPS
Gps HDOP=Горизон. погіршення точності GPS
Sat Count=Кількість супутників
AirSpeed (speed)=Повітряна швидкість (speed)
Airspeed Target (speed)=Задана повітряна швидкість (speed)
Airspeed Ratio=Коефіцієнт повітряної швидкості
GroundSpeed (speed)=Шляхова швидкість (speed)
Accel X=Прискорення X
Accel Y=Прискорення Y
Accel Z=Прискорення Z
Gyro X=Гіроскоп X
Gyro Y=Гіроскоп Y
Gyro Z=Гіроскоп Z
Mag X=Компас X
Mag Y=Компас Y
Mag Z=Компас Z
Accel2 X=Прискорення #2 X
Accel2 Y=Прискорення #2 Y
Accel2 Z=Прискорення #2 Z
Gyro2 X=Гіроскоп #2 X
Gyro2 Y=Гіроскоп #2 Y
Gyro2 Z=Гіроскоп #2 Z
Mag2 X=Компас #2 X
Mag2 Y=Компас #2 Y
Mag2 Z=Компас #2 Z
Mag Field=Магнітне Поле
Mag2 Field=Магнітне Поле #2
Mag3 Field=Магнітне Поле #3
Accel Strength=Сила Прискорення
Gyro Strength=Сила Гіроскопа
Accel2 Strength=Сила Прискорення #2
Accel3 Strength=Сила Прискорення #3
Failsafe=Відмовостійкий
RX Rssi=RX Rssi
Vertical Speed (speed)=Вертикальна швидкість (speed)
Wind Direction (Deg)=Напрямок вітру (Deg)
Wind Velocity (speed)=Швидкість вітру (speed)
Roll Target (deg)=Заданий крен (deg)
Pitch Target (deg)=Заданий тангаж (deg)
Bearing Target (deg)=Заданий пеленг (deg)
Dist to WP (dist)=Відстань до точки маршуту (dist)
Altitude Error (dist)=Похибка висоти (dist)
Bearing Error (deg)=Похибка пеленгу (deg)
Airspeed Error (speed)=Похибка повітряної швидкості (speed)
Xtrack Error (m)=Похибка Xtrack (m)
Mode=Режим
ClimbRate (speed)=Швидкість підйому (speed)
Time over Target (sec)=Час над ціллю (sec)
Time over Home (sec)=Час над дом.точкою (sec)
Dist Traveled (dist)=Пройдена відстань (dist)
Time in Air (sec)=Час у повітрі (sec)
Turn Rate (speed)=Швидкість повороту (speed)
Turn Radius (dist)=Радіус повороту (dist)
Bat Voltage (V)=Напруга батареї (V)
Bat Remaining (%)=Залишок батареї (%)
Bat Current (Amps)=Струм батареї (Amps)
Bat Watts=Потужність батареї (Watts)
Bat used EST (mah)=Використано батареї (прибл.) (mah)
Bat2 Voltage (V)=Напруга батереї #2 (V)
Bat2 Current (Amps)=Струм батареї #2 (Amps)
Bat3 Current (Amps)=Струм батареї #3 (Amps)
Bat4 Current (Amps)=Струм батареї #4 (Amps)
Bat5 Current (Amps)=Струм батареї #5 (Amps)
Bat6 Current (Amps)=Струм батареї #6 (Amps)
Bat7 Current (Amps)=Струм батареї #7 (Amps)
Bat8 Current (Amps)=Струм батареї #8 (Amps)
Bat9 Current (Amps)=Струм батареї #9 (Amps)
Distance to Home (dist)=Відстань до дом.точки (dist)
Distance From Moving Base (dist)=Відстань від рухомої бази (dist)
Elevation to Mav (deg)=Підвищення до безпілотника (deg)
Bearing to Mav (deg)=Пеленг до безпілотника (deg)
Sonar Range (alt)=Діапазон сонара (alt)
Sonar Voltage (Volt)=Напруга сонара (Volt)
3DR Radio rssi=Потужність 3DR-радіосигналу (rssi)
3DR Radio remote rssi=Потужність 3DR-сигналу дист.керув.
3DR Radio noise=Шум 3DR-радіо
3DR Radio remote noise=Шум 3DR-пульта дист.керув.
3DR Radio snr=Сигнал/Шум 3DR-радіо
3DR Radio remote snr=Сигнал/Шум 3DR-пульта дист.керув.
3DR Radio est dist (m)=3DR-радіо прибл. відстань (m)
HW Voltage=Апаратна напруга
Board Voltage=Бортова напруга
Servo Rail Voltage=Напруга серво-рейки
Voltage Flags=Прапорці напруги
Altitude (alt)=Висота (alt)
Altitude2 (dist)=Висота #2 (dist)
AOA (deg)=Кут атаки (deg)
Bat km left EST (km)=Залишок батареї (у km)
Bat efficiency (mah/km)=Ефективність батареї (mah/km)
Crit AOA (deg)=Критичний Кут атаки (deg)
Dist to Moving Base (dist)=Відстань від рухомої бази (dist)
Dist to Home (dist)=Відстань до дом.точки (dist)
Sik Radio snr=Сигнал/Шум Sik-радіо
Sik Radio est dist (m)=Sik-радіо прибл. відстань (m)
Glide Ratio=Коефіцієнт Глісади
Horizon Dist (dist)=Відстань до горизонту (dist)
Velocity Accuracy=Точність індикат. швидкості
GPS Yaw (deg)=Рискання (GPS) (deg)
GroundCourse2 (deg)=Шляховий кут #2 (deg)
Sik Radio noise=Шум Sik-радіо
IMU1 Temperature=IMU-сенсор #1: Температура
IMU2 Temperature=IMU-сенсор #2: Температура
IMU3 Temperature=IMU-сенсор #3: Температура
EFI Baro Pressure (kPa)=Інжектор: Барометр. тиск (kPa)
EFI Head Temp (C)=Інжектор: Темпер.головки блоку циліндру (C)
EFI Load (%)=Інжектор: Навантаження двигуна (%)
EFI Health=Інжектор: Справність
EFI Exhast Temp (C)=Інжектор: Температура вихлопу (C)
EFI Intake Temp (C)=Інжектор: Впускна температура (C)
EFI rpm=Інжектор: Кількість обертів
EFI Fuel Flow (g/min)=Інжектор: Потік палива (g/min)
EFI Fuel Consumed (g)=Інжектор: Палива спожито (g)
EFI Fuel Pressure (kPa)=Інжектор: Тиск палива (kPa)
Longitude2 (dd)=Довгота #2 (dd)
flow_comp_m_x=flow_comp_m_x
flow_comp_m_y=flow_comp_m_y
flow_x=flow_x
flow_y=flow_y
flow quality=flow quality
